Source Term	Target Term
peroxyacid	peroxiácido
nitrogenous hydrocarbon	hidrocarburo nitrogenado
thermolysis	descomposición térmica
multi-dimensional chromatography	cromatografía multidimensional
hydrocarbon resin	resina hidrocarbonada
TOF-MS	espectrómetro de masas de tiempo de vuelo
gel electrophoresis	electroforesis en gel
calcium hypochlorite	hipoclorito de calcio
polystyrene	poliestireno
regulated explosives precursor	precursor de explosivos regulado
24-hour flow-proportional composite sample	muestra compuesta proporcional al caudal durante un período de veinticuatro horas
membrane separation	filtración por membrana
progenitor ion	ión precursor
alkyl ester ammonium salt	sal amónica de éster alquílico
photodiode-array detection	DAD
organic phase	fase orgánica
N-nitroso amine	nitrosamina
cofactor	cofactor
X-ray fluorescence spectroscopy	fluorescencia de rayos X
Z	variable de estado
dimethylformaldehyde	dimetilcetona
electroplating	electrodeposición
intensity	intensidad
paraffin	alcano
dry mass	peso seco
originating Union act	acto de la Unión de origen
isostructural compound	compuesto isoestructural
aerobically biodegradable	biodegradable aerobiamente
C-IC	cromatografía de iones de combustión
LSA	baja actividad específica
chlorination	cloración
wood spirits	alcohol de madera
accuracy	exactitud
guanine	guanina
filter press	filtro prensa
washability	lavabilidad
liquid chromatography	cromatografía en fase líquida
constituent	constituyente
dechlorination	decloración
E599	E599
monounsaturated fatty acid	ácido graso monoinsaturado
photodiode array	ordenación de diodos
unintentional trace contaminant	contaminante en trazas no intencionales
transesterification	transesterificación
sugar	azúcar
homopolymer	homopolímero
chlor-alkali cell	célula electrolítica cloro-alkalina
lanthanoids	lantánido
ethylene oxide	óxido de etileno
bridging principle	principio de extrapolación
paper chromatography	cromatografía sobre papel
methylmercury	metilmercurio
methylene diphenyl diisocyanate	diisocianato de metilendifenilo
endothermic reaction	reacción endotérmica
nanoparticle	nanopartícula
action level	umbral de intervención
1,2-diphenylethene	estilbeno
magnesium carbonate hydroxide	subcarbonato de magnesio (ligero o pesado)
unsaturated hydrocarbon	hidrocarburo no saturado
nitrogenase	nitrogenasa
particle number-based distribution	distribución de las partículas en función de su tamaño
osmosis	osmosis
acyclic hydrocarbon	hidrocarburo acíclico
isomerisation	isomerisacion
magnesium hydride	hidruro de magnesio
fractionating column	columna de fraccionamiento
etherification	eterificación
performance criteria	criterio de aptitud
alkylation	alcoilación
dry gas	gas seco
procedural blank	blanco de procedimiento
3,4',5-trihydroxystilbene	resveratrol
multiple reaction monitoring	control de la reacción múltiple
chemiluminescence	quimioluminiscencia
acidic gas	gas ácido
isoprene	isopreno
X	variable de estado neto
business operator	operador económico
glyoxylic acid	ácido glioxílico
fatty acid	ácido graso
matrix effect	efecto matriz
adenosine 5'-monophosphate	adenosina 5'monofosfato
thymidine	timidina
hexose	hexosa
infrared spectrometry	espectrometría infrarroja
carbamate	carbamato
peroxide	peróxido
acrylonitrile butadiene styrene	acrilonitrilo butadieno estireno
calcium hydroxide	cal muerta
ion exchange column	columna de intercambio iónico
MOH	MOH
1,1,2,2-tetrachloroethene	tetracloroetano
aliquot	alícuota
anthranilic acid	ácido antranílico
electroless plating	revestimiento por reacción química
steam distillation	destilación al vapor
process chemical	sustancia química de proceso
HFO	HFO
incremental sample	muestra elemental
polyaddition	poliadición
incurred matrix	matriz real
microcrystalline petroleum wax	cera de petróleo microcristalina
expandable polystyrene	EPS
multi-material multi-layer	compuesto multicapa
fortified sample material	material de muestra enriquecido
distance selling sample	muestra de venta a distancia
treated article	artículo tratado
fragment ion	ion fragmento
error of the first kind	error de tipo I
heteroside	glucósido
foaming	formación de espuma
factorial experiment	experimento factorial
oxygen	oxígeno
per- and polyfluoroalkyl substances	perfluoroalquilos y polifluoroalquilos
crystalline phase	fase cristalina
absorption maximum	máximo de absorción
fluorochemical	compuesto fluorado
powder wetting	humectación
PAA	ácido peracético
anion exchanger	cambiador de aniones
cyclopentane	ciclopentano
fluorescence detection	detección por fluorescencia
extraction with water	extracción con agua
FAP	FAP
1,4-dioxin	1,4-dioxina
magnetic drum	tambor magnético
decompression	descompresión
solvent	disolvente
active site	centro activo
fumigant	fumigante
acetic anhydride	anhídrido acético
bioassay apparent recovery	recuperación aparente del bioensayo
field blank	blanco de campo
creosote	creosota
steam naphtha reforming	reformado con vapor de nafta
glacial acetic acid	ácido acético glacial
hexamethylene tetramine	1,3,5,7-tetraazaadamantano
emulsion breaking	rotura de la emulsión
WOPC	cemento blanco
biochemistry	química biológica
steam methane reforming	reformado con vapor de metano
butylated hydroxyanisole	BHA
phosgenation	fosgenación
nepheline	nefelina
THEE	tert-hexil hexil éter
flocculation	floculación
confirmatory method	método confirmatorio
sampled portion	porción de muestra
magnesite	magnesita
hydrophilic group	grupo hidrófilo
nitric oxide	óxido nítrico
incurred sample	muestra de estudio
glycoside	glicósido
vitrification	vitrificación
lot	lote
degreasing	desengrase
t-distribution	distribución t de Student
covalent bond	enlace covalente
nitritation	nitritación
molecular exclusion chromatography	cromatografía de exclusión por tamaños
fermentation	fermentación microbiana
elute	eluir
magnesium carbonates	carbonatos de magnesio
amount ratio	fracción molar
prussic acid	ácido cianhídrico
melting transition	fusión
atomic nucleus	núcleo atómico
Izod impact test	ensayo de Izod
metalloid	metaloide
ethylene glycol	etilenglicol
atomic mass unit	unidad de masa atómica
1,4-dichlorobenzene	p-diclorobenceno
electrophoresis	electroforesis
LFL	LIE
de-alcoholisation treatment	desalcoholización
non-ionic surface active agent	tensioactivo no iónico
interlaboratory trial	ensayo interlaboratorios
wiped film evaporator	evaporador de lámina delgada de agua
overhead gaseous stream	flujo de purga
mass balance	balance de masa
oleoresin	oleorresinas
quantitative method	método cuantitativo
carbonyl sulphide	oxisulfuro de carbono
high-resolution mass spectrometry	HRMS
TOF mass analyser	analizador de tiempo de vuelo
polymer	polímero
camphor	canfor
oxidation-reduction reaction	reacción de oxidación-reducción
trans,trans-2,4-hexadienoic acid	ácido sórbico
ECICS	Inventario Aduanero Europeo de Substancias Químicas
diagnostic ion	ion de diagnóstico
indicator electrode	electrodo indicador
metabolic pathway	ruta metabólica
reverse osmosis	ósmosis inversa
melamine	melamina
steroid	esteroide
PP	polipropileno
racemic compound	compuesto racémico
coumarin	cumarina
recovery correction	corrección de la recuperación
recovery	recuperación
ionisation	ionización
castor wax	aceite de ricino hidrogenado
nitromethane	nitrometano
polymerisation	polimerización
plate	bandeja
contamination	contaminación alimentaria
disaccharide	disacárido
yttrium oxide	itria
factorial effect	efecto factorial
surfactant	agente surfactante
uncertainty	incertidumbre
boiling reactor	reactor a temperatura de ebullición
water electrolysis	electrolisis del agua
alkylphenol ethoxylate	APEO
bio-based process	proceso de base biológica
Quat	compuesto de amonio cuaternario
UB	límite superior
halide	halogenuro
chemical conversion	conversión química
human biomonitoring data	datos de biovigilancia humana
vacuum distillation	destilación en vacío
enamel paint	esmalte
polychlorinated dibenzodioxin	dibenzo-p-dioxinas policloradas
sillimanite	silimanita
molecular weight	peso molecular
PCB	bifenilos policlorados
cationic surfactant	tensioactivo catiónico
extractable organofluorine-combustion ion chromatography	cromatografía de iones de combustión para la determinación de organoflúor extraíble
ketone	cetona
organotin compound	compuesto orgánico de estaño
immunoassay	inmunoanálisis
cytidine	citidina
bioanalysis	análisis biológico
pyrrolidinedithiocarbamate solution	solución de pirrolidinaditiocarbamato
lindane	lindane
experimental design	diseño experimental
chromatography	cromatografía
repeatability	repetibilidad
2,3,7,8-tetrachlorodibenzo-para-dioxin	2,3,7,8-tetraclorodibenzo-p-dioxina
diphenhydramine	difenhidramina
unsaponifiable matter	insaponificable
matrix	matriz
blue asbestos	crocidolita
nitrogen	ázoe
diethylene triamine pentaacetic acid	DTPA
anion	anión
adenosine disphosphate	5'-difosfato de adenosina
partition chromatography	cromatografía de reparto
field blank procedure	procedimiento de blanco de campo
mineral wax	cera mineral
self-accelerating decomposition temperature	TDAA
emission wavelength	longitud de onda de emisión
molecular ion	ion molecular
arylamine	arilamina
glucose	glucosa
fitness-for-purpose	aptitud para el uso
organometallic substance	compuesto organometálico
shake-flask method	método del matraz de agitación
polymerisation	polimerización
methyl mercaptan	metilmercaptano
graft polymer	polímero injertado
organic solvent	disolvente orgánico
substance of very high concern	SEP
non-ferrous metal	metal no férreo
calcium ammonium nitrate	nitrato de amonio y de calcio
polyalcohol	polialcohol
optical rotation	rotación óptica
plating	revestimiento
saponification value	índice de saponificación
adsorbent	adsorbente
precipitant	precipitante
2-hydroxypropanoic acid	ácido láctico
two-dimensional chromatography	cromatografía bidimensional
nitrosation	nitrosación
condensation	condensación
elution	elución
collaborative study	estudio colaborativo
Toxic Equivalency Factor	FET
immuno-affinity chromatography	CIA
matrix-fortified standard	patrón de matriz enriquecida
anion exchange membrane electrolyser	electrolizador de membrana de intercambio aniónico
colloidal system	sistema coloidal
thujone	tuyona
adduct	aducto
xylenol	xilenol
porphyry	pórfido
recovery correction factor	factor corrector de la recuperación
amount-of-substance concentration	concentración molar
bond	enlace
solution	solución
ethylenediaminetetraacetic acid	ácido etilendinitrilotetraacético
phosphorylation	fosforilación
lipophilic	lipófilo
distillation column with a dividing wall	columna de pared divisoria
2-ethylhexyl prop-2-enoate	acrilato de 2-etilhexilo
mass-to-charge ratio	m/z
specificity	selectividad
peroxide value	índice de peróxido
spectrometry	espectrometría
formaldehyde releaser	liberador de formaldehído
disodium sulfite	sulfito sódico
arachidic acid	ácido araquídico
powder coating	pintura en polvo
distillation	destilación
ICSC	ficha internacional de seguridad química
sampling frequency	frecuencia de muestreo
Database of Study Notifications	base de datos de notificaciones de estudios
salinomycin sodium	salinomicina sódica
fluorotelomer	fluorotelómero
CRM	MRC
gas liquefaction	licuefacción de gas
sodium hypochlorite	hipoclorito de sodio
ferric sodium EDTA	feredetato sódico
ion exchanger	intercambiador iónico
wet only sampling	"muestreo ""wet-only"""
Horwitz equation	ecuación de Horwitz
dye	materia colorante
polycyclic aromatic hydrocarbon	hidrocarburo aromático policíclico
cyanide	cianuro
GTP	guanosina-5'-trifosfato
y-axis intercept	ordenada en el origen
protein profiling	perfil de proteinas
acetylation	acetilación
difunctional derivative	derivado bifuncional
nanomaterial form	nanoforma
relative matrix effect	efecto matriz relativo
ethane	etano
safe and sustainable-by-design chemical	sustancia química segura y sostenible desde el diseño
PVAL	alcohol polivinílico
macromolecule	macromolécula
hydrogen	E 949
sodium carbonates	E 500
volatile compound	compuesto volátil
representative sample	muestra representativa
hazard statement	indicación de peligro
optical activity	actividad óptica
ion	ion
GC/HRMS	cromatografía de gases con detección por espectrometría de masas de alta resolución
gas chromatography	CG
proficiency test	prueba de aptitud
chromatographic separation	separación cromatográfica
basalt	basalto
parts per million	ppm
oligosaccharide	oligosacáridos
adsorption	adsorción
stoichiometric excess	exceso estequiométrico
STC	concentración de cribado establecida
phase separation	separación de fases
NADH	forma reducida de nicotinamida-adenina dinucleótido
adenylate cyclase	adenilil ciclasa
pressure swing adsorption	adsorción por oscilación de presión
carbon dioxide snow	hielo seco
cytosine	citosina
endo-1,3(4)-β-glucanase	endo-1,3(4)-beta-glucanasa
ADR	ADR
cyclic hydrocarbon	hidrocarburo cíclico
recombinase	recombinasa
trueness	veracidad
ethanenitrile	acetonitrilo
level of interest	nivel de interés
POM	resina acetal
thermal reduction	reducción térmica
dioxin-like compound	compuesto similar a la dioxina
chromium(VI)	cromo hexavalente
sample division	división de la muestra
pentose	pentosa
de novo synthesis	síntesis de novo
quaternary ammonium cation	catión de amonio cuaternario
phenylacetic acid	ácido fenilacético
eluent	eluyente
boiling point	temperatura de ebullición
hexamine fuel tablet	pastilla de combustible de hexamina
isocyanatomethane	isocianato de metilo
MALDI-TOF mass spectrometry	espectrometría de masas MALDI-TOF
fluorine	flúor
galactose	galactosa
toxic equivalent	TEQ
liquid-solid chromatography	cromatografía de adsorción
peroxyformic acid	ácido peroxifórmico
autoclave	autoclave
TCD	destilación térmicamente acoplada
guanosine	guanosina
OPs	organofosfatos
restriction dossier	expediente de restricción
catalyst poison	veneno del catalizador
plane chromatography	cromatografía planar
target ion	ión diana
deep-bed filtration	filtración en lecho profundo
biomolecule	biomolécula
impurity	impureza
organosulphide	sulfuro orgánico
chlorodifluoromethane	monoclorodifluorometano
platinoid	metal del grupo del platino
isomer	isómero
isolated intermediate	sustancia intermedia aislada
analyte	analito
precipitate	precipitado
sodium hydride	hidruro sódico
residence time	tiempo de permanencia
gravity separation	separación por gravedad
full width at half maximum	anchura de banda a media altura
saturated hydrocarbon	hidrocarburo saturado
chain transfer agent	reactivo de transferencia de cadena
structural elucidation	elucidación de la estructura
Chemical Safety Report	ISQ
tritium	tritio
PET	tereftalato de polietileno
test tube	tubo de ensayo
HPLC-FLD	HPLC con detección de fluorescencia
restricted explosives precursor	precursor de explosivos restringido
evaporation	evaporación
qualitative method	método cualitativo
nitric acid	ácido nítrico
side chain	cadena lateral
boric acid	ácido ortobórico
halogenic hydrocarbon	halocarbono
copper sulfate pentahydrate	pentahidrato de sulfato de cobre(II)
van der Waals forces	fuerzas de Van der Waals
multi-analyte method	método multianalito
daughter ion	ion producto
electrolyser	electrolizador
liquid phase separation	separación de la fase líquida
sodium tripolyphosphate	tripolifosfato sódico
MOSH	MOSH
atom	átomo
potassium permanganate	permanganato potásico
bed	lecho
tripeptide	tripéptido
Zahn-Wellens test	prueba Zahn-Wellens
frother	sustancia espumante
relative intensity	intensidad relativa
mass chromatogram	cromatograma de iones extraídos
co-chromatography	cocromatografía
detonation	detonación
sandstone	arenisca
D-glucono-1,5-lactone	D-glucono-1,5-lactona
reference material	material de referencia
reproducibility	reproducibilidad
equilibrium constant	constante de equilibrio
natural polymer not chemically modified	polímero natural no modificado químicamente
CV	coeficiente de determinación
ferric chloride	cloruro de hierro (III)
guanosine diphosphate	guanosina difosfato
polyurethane	poliuretano
existing furnace	horno de proceso existente
digestion apparatus	aparato de digestión
hydriodic acid	ácido yodhídrico
analytical detection limit	límite de detección analítico
butylated hydroxytoluene	E 321
mass spectrophotometry	espectrometría de masa
derivatisation	derivatización
iodine value	índice de yodo
sampling	toma de muestras
factorial approach	enfoque factorial
calcination	calcinación
enzyme inhibition	inhibición enzimática
1,1-dichloroethane	1,1-dicloroetano
chloro-organic substance	compuesto organoclorado
regeneration liquid	líquido de regeneración
ion exchange	intercambio de iones
earth wax	cera de Moldavia
plexiglass	plexiglás
incomplete combustion	combustión incompleta
cyanite	cianita
non-competitive inhibition	inhibición no competitiva
distribution constant	coeficiente de distribución
dieldrin	dieldrina
fluorescence quenching	desactivación
VPVB	muy persistente y muy bioacumulable
paraformaldehyde	paraformaldehído
coacervation	coacervación
reflux	reflujo
LRMS	EMBR
liquefaction	licuefacción
pigment	pigmento
calomel electrode	electrodo de referencia de calomelanos
lactone	lactona
adenine	adenina
linolenic acid	ácido linoleico
duty holder	responsable del cumplimiento
mineral oil	aceite mineral
2-methoxy-2-methylpropane	metil-terbutiléter
glycerine	glicerina
electron ionization	ionización por impacto electrónico
polarity	polaridad
oxidation	oxidación
tert-pentyl methyl ether	TAME
ethylene	eteno
gravitational settling	sedimentación gravitacional
extrapolation	extrapolación
peat wax	cera de turba
stoichiometric mixture	mezcla estequiométrica
platelet	plaquita
chalk	carbonato de calcio
MALDI	MALDI
excitation wavelength	longitud de onda de excitación
coenzyme	coenzima
zwitterion	ión anfótero
beryl	berilo
hydraulic lime	cal hidráulica
mass spectrometer	espectrómetro de masas
wool wax	grasa de lana
hydrochlorofluorocarbon	(hidro)clorofluorocarburo
sampling point	punto de muestreo
uridine	uridina
sodium lauryl sulfate	dodecilsulfato de sodio
nanomaterial	nanomaterial
analytical portion	porción de ensayo
reducing agent	reductor
chlorinated hydrocarbon	compuestos de organocloro
chlorine-containing substance	compuesto clorado
true positive	verdadero positivo
SFE	EFS
atmospheric nitrogen	gas nitrógeno
marble	mármol
nitrite	nitrito
qualifier ion	ión cualificador
reduction	reducción
2D gel electrophoresis	electroforesis bidimensional en gel
chicken meat	pollo
stoichiometry	estequiometría
solute	soluto
precision	precisión
bromocresol purple	púrpura de bromocresol
HPLC-DAD	cromatografía líquida con detección por diodos en serie
ion-exchange polymer	resina de intercambio iónico
absorbable organichalogenated compounds	sustancias organohalogenadas adsorbibles
polychlorodibenzofuran	PCDF
standard analyte	analito patrón
condenser	condensador
minimum detectable value of the net state variable	valor mínimo detectable de la variable de estado neto
gravel	grava
total emissions	emisiones totales
plastisol	plastisol
reduced sample	muestra reducida
mass spectrometry	espectroscopia de masas
inductively coupled plasma atomic emission spectroscopy	ICP-AES
SMILES	SMILES
ferrous salt	sal ferrosa
molecular fluorine	flúor
standard addition	adición de patrón
reference state	estado de referencia
macadam	macadán
endo-1,4-beta-xylanase	endo-1,4-beta-xilanasa
adduct ion	ion aducto
biological oxidation	biooxidación
nuclide	núclido
stickiness	pegajosidad
bioanalytical equivalent	equivalente bioanalítico
DT	desolventador-tostador
Orbitrap	Orbitrap
aniline	anilina
polyolefin	poliolefina
pentachlorophenol	pentaclorofenol
standard volumetric solution	solución volumétrica
curing oven	horno de curado
tert-hexyl methyl ether	tert-hexil metil éter
sulfamide	sulfamida
glass transition	transición vítrea
ignition loss	pérdida por calcinación
restricted substance	sustancia restringida
plate column	columna de bandejas
fluorspar	fluorita
supercritical fluid chromatography	SFC
sulfurous hydrocarbon	hidrocarburo sulfurado
hexahydropyridine	piperidina
backwashing liquid	líquido de retrolavado
polysaccharide	polisacárido
porcelainite	mullita
measurand	mensurando
low-purity nitrogen	nitrógeno de baja pureza
anion exchange membrane water electrolysis	electrólisis por membrana de intercambio aniónico
qualitative analysis	análisis cualitativo
magnesium carbonate	E 504 (i)
RSL	lista de sustancias restringidas
co-extrusion	extrusión de varias capas
TDI	diisocianato de toluileno
hydrogen cyanide	cianuro de hidrógeno
cryo-condensation	condensación criogénica
multiple ion monitoring	registro selectivo de iones
saponin	saponina
benzene	benceno
MSn	espectrometría de masas de múltiples etapas
peak height	altura de pico
β-lactam ring	anillo betalactámico
packing material	material de relleno
garnet	granate
dioxin-like PCB	policlorobifenilos similares a las dioxinas
isopropyl alcohol	alcohol isopropilo
analytical tolerance	tolerancia analítica
MAH	anhídrido maleico
emissivity	emisividad
hydrophobic group	grupo hidrófobo
sodium hydroxide solution	hidrato de sodio
in-house validation	validación interna
hydrobromic acid	ácido bromhídrico
granite	granito
glycogen	glucógeno
extrusion	moldeo por extrusión
ethyl benzene	etilbenceno
2-methyl-2-ethoxypropane	ETBE
emulsifiability	poder emulsionante
sodium sesquicarbonate	sesquicarbonato sódico
ionic bond	enlace iónico
chemical reduction	reducción
AEM	membrana de intecambio aniónico
chlorate	clorato
CAS Number	número de registro CAS
polychlorinated dibenzo-p-dioxins and dibenzofurans	PCDD/F
ferrous	férrea (aleación)
fermentation	fermentación
brominated flame retardant	material ignífugo bromado
amphoteric surfactant	tensioactivo anfotérico
control group	grupo de control
PDA	PDA
two-stage dust filter	filtro de polvo en dos etapas
HBFC	hidrobromofluorocarbono
leucite	silicato doble de aluminio y potasio
polybrominated diphenyl ether	difeniléter polibromado
oxidiser	oxidante
ultra-high-molecular-weight polyethylene	HPPE
microfloc particle	microflóculo
active substance starting material	material de partida
uncompetitive inhibition	inhibición acompetitiva
phenanthrene	fenantreno
dissociation constant	constante de disociación
humectant	humectante
fluidized-bed reactor	reactor con lecho fluidificado
glycosidic bond	enlace glicosídico
safe and sustainable-by-design	seguridad y sostenibilidad desde el diseño
internal standard	patrón interno
to dewater	eliminar el agua
DIA	DIA
drag-out	arrastre
on dry matter basis	en materia seca
matrix-matched standard	patrón similar a la matriz
anionic surfactant	tensoactivo aniónico
hydrate	hidrato
Respirometric Index	índice respirométrico
organophosphorus compound	compuesto organofosforado
prop-2-enenitrile	2-propenonitrilo
neutralisation	neutralización
reference electrode	electrodo de referencia
chemical biology	biología química
polypropylene glycol	polipropilenglicol
paraffin wax	cera de parafina
aggregate sample	muestra global
rare earth metals	elemento de tierra rara
blending	mezclado
spent air	aire agotado
isobar	isobaro
bicarbonate of soda	carbonato ácido de sodio
allosteric site	sitio alostérico
liquid chromatography-tandem mass spectrometry	cromatografía de líquidos acoplada a espectrografía de masas en tándem
ordinary portland cement	cemento de Pórtland
reflux	reflujo
monosaccharide	monosacáridos
dehydrogenation	deshidrogenación
partial polyglycerol esters of polycondensed fatty acids of castor oil	E 498
short chain chlorinated paraffin	parafina clorada de cadena corta
affinity chromatography	cromatografía de afinidad
coenzyme A	coenzima A
absorbance unit	unidad de absorbancia
floccule	floculación
Horwitz ratio	HorRat
urea	urea
carbon monoxide	protóxido de carbono
emery	esmeril
telomerisation	telomerización
chlor-alkali	cloruro alcalino
alloy	aleación
chemical ionization	CI
retort carbon	carbón de retorta
LCL	nivel mínimo calibrado
bubbling	gasificación
sand filtration	filtración de arena
phase boundary	límite de fase
reaction product	producto de reacción
thermal desorption	desorción térmica
hydro(chloro)fluoroolefin	hidroclorofluoroolefina
monomer	monómero
trimethyl phosphite	fosfito de trimetilo
azocolourant	colorante azoico
spiking	fortificación
electrophoretic deposition	recubrimiento electroforético
fixed-bed filter	filtro de lecho fijo
hot-melt adhesive	cola termoplástica
kinase	quinasa
tricarboxylic acid cycle	ciclo de ácido cítrico
1H-pyrimidine-2,4-dione	uracilo
turbidity	turbiedad
mixing	mezclado
concentration	concentración
glyoxal	glioxal
electrocoating	electrorrecubrimiento
chemicals data	datos sobre sustancias químicas
diol	alcohol dihídrico
fraction	corte
solvated electron	electrón solvatado
ruggedness	robustez
agitator	agitador
Hydride AAS	espectrometría de absorción atómica de generación de hidruros
hydrogen chloride	cloruro de hidrógeno
monoterpene	monoterpeno
non-dioxin-like polychlorinated biphenyl	PCB no similar a la dioxina
protein kinase	proteinquinasa
sample blank determination	blanco
plastic multi-layer	plástico multicapa
metallic hydrogen	hidrógeno metálico
ethylene dichloride	1,2-dicloroetano
struvite	estruvita
sodium carbonate	carbonato de sodio
organic compound	compuesto orgánico
heavy metal	metal pesado
polyhydroxyalkanoate	PHA
LB-sum	suma del límite inferior
saponification	saponificación
curtain coating	extendido por cortina
acid salt	sal ácida
carboxylic acid	acido carboxilico
cell-based assay	análisis en células
gas evolution	producción de gas
WHO-TEQ	EQT-OMS
alcohol dehydrogenase	alcohol deshidrogenasa
caustic soda	sosa cáustica
corrosiveness	corrosividad
hexachlorocyclohexane	HCH
chain transfer	transferencia de cadena
dichloroethane	dicloroetano
furan	furano
polyethylene	polietileno
atomic absorption spectroscopy	espectrometría de absorción atómica
SBP solvent	alcohol industrial
hydrophobic	hidrófobo
ethylcellulose	etilcelulosa
isobaric ion	ion isobárico
pyrimidine	pirimidina
ω3-polyunsaturated fatty acid	ácido graso omega-3
radiation curing	curado por radiación
carbon dioxide	gas carbónico
extraction	extracción
CFC	CFC
existing process heater	calentador de proceso existente
ammonium ion	amonio
aminosugar	osamina
coverage factor	factor de cobertura
kieserite	kieserita
diethyl phthalate	ftalato de dietilo
flame retardant	retardante de llama
uric acid	ácido úrico
high-pressure liquid chromatography	cromatografía líquida de alto rendimiento
FTOH	alcohol fluorotelomérico
chemically modified natural polymer	polímero natural modificado químicamente
PVC slurry	lechada de PVC
phenol red	rojo de fenol
solvent blank	blanco del disolvente
time-proportional sample	muestra proporcional al tiempo
spent solvent	disolvente usado
confirmatory test	prueba confirmativa
goodness of fit	precisión del ajuste
ethyl acrylate	acrilato etílico
accordance check	comprobación de conformidad
analytical method	método analítico
ozone	ozono
MOAH	MOAH
copper sulfate	sulfato de cobre
buta-1,3-diene	butadieno
monomer unit	unidad monomérica
fluorocarbon	hidrocarburos fluorados
3-hydroxybutyric acid	ácido 3-hidroxibutírico
screening method	método de cribado
evaporator	evaporador
ultrasonic cleaning	limpieza ultrasónica
proteolysis	proteólisis
critical value of the net state variable	valor crítico de la variable de estado neto
permeate	filtrado
cyclin-dependent kinase	cinasa ciclinodependiente
in-house reproducibility	RSDWR
slag cement	cemento siderúrgico
semi-quantitative method	método semicuantitativo
chemical name	nombre químico
carbon tetrachloride	tetraclorometano
proton	protón
lignite wax	cera de lignito
barytes	sulfato bárico natural
tie resin	capa de unión
alkali	álcali
holoside	holosido
glycerol esters of condensed castor oil fatty acids	PGPR
cleavage	descomposición
phenylenediamine	fenilendiamina
vapour tension	tensión de vapor
condensative chain polymerisation	polimerización por condensación
SRM	control de la reacción seleccionada
full-scan diode array detection spectrophotometry	detección espectrofotométrica por red de diodos mediante barrido completo
shogaol	shogaol
phenol	fenol
filtration with continuous deposition	filtración por aluvionado continuo
by weight	porcentaje en peso
alpha-hydroxy acid	alfahidroxiácido
fabric filter	filtro de tela
soapstone	esteatita
syenite	sienita
β error	falso negativo
cracking	craqueo
calcium dichloride	E 509
hydrogen-2	deuterio
synthetic rubber	caucho sintético
mobile phase	fase móvil
IPC	cromatografía de pares iónicos
alkylation	alquilación
hydrogen peroxide	agua oxigenada
petroleum bitumen	betún de petróleo
micromole	micromol
extractive distillation	destilación extractiva
gas chromatograph-tandem mass spectrometry	cromatografía de gases-espectrometría de masas
azo pigment	pigmento azoico
poly vinyl butyral	PVB
recrystallisation	recristalización
suspended solids	sustancia en suspensión
hydrogen bromide	bromuro de hidrógeno
volatile fatty acid	ácido graso volátil
retention time	tiempo de retención
terpene	terpeno
glycol	glicol
eluate	eluato
technical grade	calidad técnica
malic acid(COOH.CH2.CHOH.COOH)	ácido málico
mechanical separator	separador
calibration standard	patrón de calibración
ingoing substance	sustancia entrante
mercaptan	mercaptano
racemate	racemato
mist filter	separador de gotas
spontaneous ignition temperature	temperatura de inflamación espontánea
electrodialysis	electrodiálisis
addition polymerisation	polimerización por adición
PPA	auxiliar para la producción de polímeros
isotope-labelled compound	compuesto marcado isotópicamente
ADPR	ADP-ribosa
alkyl phenol ethoxylate	APEO
anodizing	anodización
iron pyrite	pirita
on dry substance	en sustancia seca
LB	límite inferior
basic state	estado básico
fragmentation	reacción de fragmentación
andalusite	andalucita
monazite	monacita
acetic acid	ácido acético
persistent, bioaccumulative and toxic	PBT
distillation column	columna de destilación
supercritical CO2 extraction	extracción mediante CO2 supercrítico
flat flame burner	quemador de llama plana
digestion	digestión
receptor-ligand binding assay	análisis de fijación a receptores
