Source Term	Target Term	IATE
radiopharmaceutical	radiofármaco	IATE
sulfonterol	sulfonterol	IATE
toliodium chloride	cloruro de toliodio	IATE
natural immunity	inmunidad natural	IATE
column leachable	lixiviables de columna	IATE
sarilumab	sarilumab	IATE
sulfalene	sulfaleno	IATE
stratified analysis	análisis estratificado	IATE
pharmaceutical strategy	Estrategia Farmacéutica para Europa	IATE
underdosage	posología insuficiente	IATE
vaccine protein	proteína vacunal	IATE
tiospirone	tiospirona	IATE
tenosal	tenosal	IATE
red yeast rice	arroz de levadura roja	IATE
sulfametrole	sulfametrol	IATE
sulfapyrazole	sulfapirazol	IATE
sunagrel	sunagrel	IATE
tivirapine	tivirapina	IATE
cold expression	expresión en frío	IATE
interval summary tabulation	cuadro resumen de intervalos de exposición	IATE
tiopropamine	tiopropamina	IATE
combination veterinary medicinal product	medicamento veterinario en asociación	IATE
bio-material	biomaterial	IATE
flumequine	flumequina	IATE
quarantined	en cuarentena	IATE
unique identifier	identificador exclusivo	IATE
tamibarotene	tamibaroteno	IATE
centralised authorisation procedure	procedimiento centralizado	IATE
functional effect	efecto funcional	IATE
clinical performance	rendimiento clínico	IATE
islets	islote pancreático	IATE
timegadine	timegadina	IATE
tenidap	tenidap	IATE
closed system	sistema cerrado	IATE
good laboratory practice	buenas prácticas de laboratorio	IATE
tetramethrin	tetrametrina	IATE
narcotic drug	estupefaciente	IATE
todralazine	todralazina	IATE
antimicrobial consumption	consumo de antimicrobianos	IATE
anti-tampering device	dispositivo contra las manipulaciones	IATE
baricitinib	baricitinib	IATE
menadione	menadiona	IATE
lidocaine	lidocaína	IATE
timepidium bromide	bromuro de timepidio	IATE
manufacturing route	vía de fabricación	IATE
sulfamethoxypyridazine	sulfametoxipiridazina	IATE
chylomicron	quilomicrón	IATE
texacromil	texacromilo	IATE
thenyldiamine	tenildiamina	IATE
tetryzoline	tetrizolina	IATE
sulisatin	sulisatina	IATE
equipment qualification	cualificación del equipo	IATE
conformity assessment procedure	evaluación de la conformidad	IATE
sulotroban	sulotrobán	IATE
sulfacetamide	sulfacetamida	IATE
sulicrinat	sulicrinat	IATE
suloctidil	suloctidil	IATE
dose-effect relationship	relación dosis-efecto	IATE
formulation	fórmula	IATE
design qualification	cualificación del diseño	IATE
retrievability	recuperabilidad	IATE
essential similarity	similitud esencial	IATE
ancillary substance	sustancia accesoria	IATE
oncogenicity	oncogenicidad	IATE
homeopathic stock	cepa homeopática	IATE
adrenaline	adrenalina	IATE
causality method	método de causalidad	IATE
traceability	trazabilidad	IATE
sulfanilamide	sulfanilamida	IATE
sulfatrozole	sulfatrozol	IATE
ternidazole	ternidazol	IATE
quarantined material	material en cuarentena	IATE
tenylidone	tenilidona	IATE
muscarinic receptor	receptor colinérgico muscarínico	IATE
official medicines control laboratory	Laboratorio Oficial de Control de Medicamentos	IATE
clinical trial	ensayo clínico	IATE
officinal formula	fórmula oficinal	IATE
strength of the medicinal product	dosis del medicamento	IATE
anaesthetic	anestésico	IATE
key input	insumo clave	IATE
teroxalene	teroxaleno	IATE
off-label use	uso no contemplado	IATE
tiracizine	tiracizina	IATE
drug safety monitoring	vigilancia farmacológica	IATE
regdanvimab	regdanvimab	IATE
post-market clinical follow-up	seguimiento clínico poscomercialización	IATE
overdose	sobredosis	IATE
medication misuse	uso indebido	IATE
tocainide	tocainida	IATE
sultroponium	sultroponio	IATE
innovation principle	principio de innovación	IATE
tibric acid	ácido tíbrico	IATE
critical shortage	escasez crítica	IATE
sulfadiazine	sulfadiazina	IATE
live attenuated vaccine	vacuna viva atenuada	IATE
pharmaceutical research	investigación farmacéutica	IATE
radionuclide	radionúclido	IATE
tiflucarbine	tiflucarbina	IATE
plasmid cloning vector	plásmido vector	IATE
generic drift	deriva genérica	IATE
proprietary pharmaceutical product	especialidad farmacéutica	IATE
tinofedrine	tinofedrina	IATE
responsible person	persona responsable	IATE
beta-Estradiol	estradiol-17ß	IATE
suncillin	suncilina	IATE
sulfamethoxazole	sulfametoxazol	IATE
rapid test	prueba rápida	IATE
co-transfection	transfección múltiple	IATE
Plasma Master File inspection	inspección de archivo principal sobre plasma	IATE
tazofelone	tazofelona	IATE
chloroquine	cloroquina	IATE
tarazepide	tarazepida	IATE
terciprazine	terciprazina	IATE
receptor antagonist	antagonista	IATE
herbal veterinary medicinal product	medicamento veterinario a base de plantas	IATE
manufacturing process	proceso de fabricación	IATE
tolnapersine	tolnapersina	IATE
relative clinical effectiveness	eficacia clínica relativa	IATE
tipentosin	tipentosina	IATE
control arm	grupo de control	IATE
receptor binding	unión a los receptores	IATE
pilot study	estudio piloto	IATE
antiretroviral	antirretroviral	IATE
immediate package	acondicionamiento primario	IATE
Member State Coordination Group on Health Technology Assessment	Grupo de Coordinación	IATE
continuous use	funcionamiento continuo	IATE
cartilage	cartílago	IATE
procurement on behalf of or in the name of the Member States	contratación por cuenta o en nombre de los Estados miembros	IATE
medicinal products authority	autoridad sobre medicamentos	IATE
medical nutrition	nutrición médica	IATE
GMP	buenas prácticas de fabricación	IATE
top-line results	resultados preliminares	IATE
sulfametomidine	sulfametomidina	IATE
PNEC	PNEC	IATE
lincomycin	lincomicina	IATE
anthranilic acid	ácido antranílico	IATE
Global Action Plan on AMR	Plan de Acción Mundial sobre la Resistencia a los Antimicrobianos	IATE
name of the medicinal product	denominación del medicamento	IATE
steam distillation	destilación al vapor	IATE
counterfeit medicinal product	medicamento falsificado	IATE
tiocarlide	tiocarlida	IATE
MAH	TAC	IATE
sulverapride	sulveraprida	IATE
indicator commensal bacterium	bacteria indicadora comensal	IATE
antibiotic sensitivity	sensibilidad a los antibióticos	IATE
dissolution rate	tasa de disolución intrínseca	IATE
Joint Procurement Agreement	Acuerdo de Adquisición Conjunta	IATE
taleranol	taleranol	IATE
fluorouracil	fluorouracilo	IATE
sieving	cribado	IATE
charge	gasto administrativo	IATE
clinical investigation	investigación clínica	IATE
FDC	medicamento de combinación de dosis fijas	IATE
talopram	taloprán	IATE
sulfafurazole	sulfafurazol	IATE
tolbutamide	tolbutamida	IATE
bona fide unsolicited order	prescripción para uso compasivo	IATE
non-steroidal anti-inflammatory drug	fármaco antiinflamatorio no esteroideo	IATE
National Competent Authorities on Pricing &amp; Reimbursement and public healthcare payers	red de autoridades competentes para la fijación de precios y reembolso	IATE
returned active substance	principio activo devuelto	IATE
tolmetin	tolmetina	IATE
tibalosin	tibalosina	IATE
talosalate	talosalato	IATE
tegafur	tegafur	IATE
mutagenicity	poder mutágeno	IATE
NTE	nueva entidad terapéutica	IATE
talviraline	talviralina	IATE
powder wetting	humectación	IATE
teloxantrone	teloxantrona	IATE
strip pack	Tiras	IATE
osmolality	osmolalidad	IATE
EDQM	EDQM	IATE
vaccine rollout	despliegue de vacunas	IATE
dose-related response	relación dosis-respuesta	IATE
pathogen	patógeno	IATE
International Council for Harmonisation of Technical Requirements for Pharmaceuticals for Human Use	Conferencia Internacional sobre Armonización	IATE
immunological	medicamento veterinario inmunitario	IATE
ACE inhibitor	inhibidor de la enzima conversiva de la angiotensina	IATE
marketing authorisation for a limited market	autorización de comercialización para un mercado limitado	IATE
terizidone	terizidona	IATE
ritonavir	ritonavir	IATE
revocation of a marketing authorisation	revocación de la autorización de comercialización	IATE
tolnidamine	tolnidamina	IATE
vaccine-escape variant	variante que elude la inmunidad vacunal	IATE
clinical trial subject	sujeto de ensayo	IATE
benefit-risk balance	relación riesgo/beneficio	IATE
same veterinary medicinal product	mismo medicamento veterinario	IATE
tetrazolast	tetrazolast	IATE
tifluadom	tifluadom	IATE
thenium closilate	closilato de tenio	IATE
pest infestation	infestación	IATE
commensal	comensal	IATE
partition coefficient	coeficiente de reparto	IATE
sulglicotide	sulglicotida	IATE
good storage practices	BPA	IATE
sumetizide	sumetizida	IATE
timoprazole	timoprazol	IATE
acetic anhydride	anhídrido acético	IATE
1,8-dihydroxy-9,10-anthraquinone	dantrón	IATE
tilnoprofen arbamel	tilnoprofeno arbamel	IATE
quality review of documents	control de la calidad de los documentos	IATE
antisense transcript	ARN antisentido	IATE
sulfathiazole	sulfatiazol	IATE
pharmacopeia	farmacopea	IATE
minimum storage life	fecha de consumo preferente	IATE
tioxolone	tioxolona	IATE
method of administration	método de administración	IATE
sulfadiazine sodium	sulfadiazina sódica	IATE
crushing	trituración	IATE
tiaprofenic acid	ácido tiaprofénico	IATE
data protection	protección de los datos	IATE
periodic safety update report	informe periódico de seguridad	IATE
confounding variable	factor de confusión	IATE
tiotidine	tiotidina	IATE
trastuzumab	trastuzumab	IATE
tifurac	tifuraco	IATE
sulopenem	sulopenem	IATE
dispensation	dispensación	IATE
push incentive	incentivo de estímulo	IATE
tandamine	tandamina	IATE
public health emergency	emergencia de salud pública	IATE
incurred sample	muestra de estudio	IATE
tioperidone	tioperidona	IATE
endemic	endemia	IATE
immune escape variant	variante que elude la inmunidad	IATE
tibrofan	tibrofán	IATE
batch number	número de lote	IATE
electronic common technical document	documento técnico común electrónico	IATE
Critical Medicines Act	Ley de Medicamentos Críticos	IATE
phenothiazine	fenotiazina	IATE
metastatic cancer	cáncer con metástasis	IATE
tagorizine	tagorizina	IATE
tioxidazole	tioxidazol	IATE
tiotropium bromide	bromuro de tiotropio	IATE
blinding	enmascaramiento	IATE
telenzepine	telenzepina	IATE
tazeprofen	tazeprofeno	IATE
taurosteine	taurosteína	IATE
off-patent medicinal product	medicamento sin patente	IATE
The Rules Governing Medicinal Products in the European Union	Normas sobre medicamentos de la Unión Europea	IATE
case-control study	estudio de casos y testigos	IATE
raw material	materia prima	IATE
teflutixol	teflutixol	IATE
para-acetylaminophenol	paracetamol	IATE
mono-national active substance	principio activo mononacional	IATE
thymostimulin	timoestimulina	IATE
tetracosactide	tetracosactida	IATE
parent radionuclide	padre	IATE
biological assay	ensayo biológico	IATE
antibiogram	antibiograma	IATE
LPLD	deficiencia de lipoproteína lipasa	IATE
sunepitron	sunepitrón	IATE
terbogrel	terbogrel	IATE
tazolol	tazolol	IATE
Declaration of the United Nations high-level meeting of the General Assembly on AMR	Declaración Política de la reunión de alto nivel de la AsambleaGeneral sobre la resistencia a los antimicrobianos	IATE
tesicam	tesicam	IATE
tematropium metilsulfate	metilsulfato de tematropio	IATE
tebuquine	tebuquina	IATE
antiviral drug	antiviral	IATE
nucleic acid amplification technology	técnica de amplificación de ácidos nucleicos	IATE
in silico	informático	IATE
testolactone	testolactona	IATE
rechallenge	reexposición	IATE
priority pathogen	patógeno prioritario	IATE
autologous	autógeno	IATE
MTBVAC vaccine	vacuna MTBVAC	IATE
muscle relaxant	miorrelajante	IATE
SAR	SRA	IATE
post-market surveillance	vigilancia poscomercialización	IATE
post-marketing surveillance study	estudio de supervisión posterior a la comercialización	IATE
reference safety information	información de seguridad de referencia	IATE
Community herbal monograph for herbal medicinal products	monografía comunitaria sobre plantas medicinales	IATE
precursor	precursor químico	IATE
RWD	datos de la vida real	IATE
suspected unexpected serious adverse reaction	sospecha de reacción adversa grave e inesperada	IATE
sulfaloxic acid	ácido sulfalóxico	IATE
annual safety report	informe anual de seguridad	IATE
Emergency Use Authorisation	autorización de uso urgente	IATE
good distribution practice	BPD	IATE
tolpadol	tolpadol	IATE
tampramine	tampramina	IATE
paediatric use marketing authorisation	ACUP	IATE
tofacitinib	tofacitinib	IATE
storage life	periodo de validez	IATE
early hazard identification	perfil de riesgo preliminar	IATE
steroid	esteroide	IATE
originator medicine	medicamento originador	IATE
feed premixture	premezcla	IATE
nec	no clasificado en otra parte	IATE
tibolone	tibolona	IATE
recovery	recuperación	IATE
pharmaceutical product	medicamento	IATE
preventive treatment	prevención	IATE
gastro-resistant capsule, hard	cápsula dura gastrorresistente	IATE
minimum inhibitory concentration	concentración mínima inhibitoria	IATE
tianeptine	tianeptina	IATE
health threat	amenaza para la salud	IATE
validation	validación	IATE
treatment	tratamiento	IATE
SmPC	RCP	IATE
activity test	prueba de actividad	IATE
terguride	tergurida	IATE
tizoprolic acid	ácido tizoprólico	IATE
tiafibrate	tiafibrato	IATE
viral vector vaccine	vacuna vectorial vírica	IATE
fluoroquinolone	fluoroquinolona	IATE
DNA vaccine	vacuna genética	IATE
thonzylamine	toncilamina	IATE
list of questions	lista de preguntas	IATE
CRPC	cáncer de próstata resistente a la castración	IATE
absolute bioavailability	biodisponibilidad	IATE
dose	dosis	IATE
SoHO Coordination Board	Junta de Coordinación de SoHO	IATE
telmisartan	telmisartán	IATE
undesirable effect	reacción adversa	IATE
temafloxacin	temafloxacino	IATE
device intended for clinical investigation	producto sanitario destinado a investigaciones clínicas	IATE
efficacy profile	eficacia	IATE
EU Executive Steering Group on shortages of medicines caused by major events	grupo director ejecutivo	IATE
sulfaquinoxaline	sulfaquinoxalina	IATE
permitting procedure	proceso de concesión de autorizaciones	IATE
placebo	placebo	IATE
sulfametoxydiazine	sulfametoxidiazina	IATE
tefazoline	tefazolina	IATE
testosterone ketolaurate	cetolaurato de testosterona	IATE
pharmacokinetics	farmacocinética	IATE
tioclomarol	tioclomarol	IATE
tolimidone	tolimidona	IATE
causal association	asociación causal	IATE
pharmacovigilance inspection	inspección en el marco de la farmacovigilancia	IATE
case narrative	exposición del caso	IATE
maximum concentration	Cmáx	IATE
Committee for Proprietary Medicinal Products	Comité de medicamentos de uso humano	IATE
genetic reassortment	reagrupamiento de genes	IATE
IRN	red de análisis de incidentes	IATE
allergen medicinal product	producto alergénico	IATE
terflavoxate	terflavoxato	IATE
signal	señal	IATE
sulodexide	sulodexida	IATE
adventitious agent	agente adventicio	IATE
spread of AMR	propagación de la resistencia a los antimicrobianos	IATE
carbapenemase	carbapenemasa	IATE
molecular weight	peso molecular	IATE
teriparatide	teriparatida	IATE
refraction	aberración	IATE
clinical breakpoint	valor crítico	IATE
thiofuradene	tiofuradeno	IATE
emvododstat	emvododstat	IATE
check valve	válvula antirretorno	IATE
tivanidazole	tivanidazol	IATE
ticabesone	ticabesona	IATE
subtherapeutic dose	dosis subterapéutica	IATE
innovative medicinal product	medicamento innovador	IATE
substantial modification	modificación sustancial	IATE
gene therapy	terapia génica	IATE
hydrocortisone	hidrocortisona	IATE
tolgabide	tolgabida	IATE
tissue engineered product	producto de ingeniería tisular	IATE
essential medicine	medicamento esencial	IATE
Nordic Pharmaceutical Forum	Foro Farmacéutico Nórdico	IATE
storage life	vida útil de almacenamiento	IATE
tiformin	tiformina	IATE
experimental design	diseño experimental	IATE
antimicrobial stewardship plan	plan de gestión de los antimicrobianos	IATE
side effect	efecto colateral	IATE
designated orphan medicinal product	medicamento declarado huérfano	IATE
sulfasomizole	sulfasomizol	IATE
microbiological purity	pureza microbiológica	IATE
JAP	Programa Conjunto de Auditoría	IATE
tiamulin	tiamulina	IATE
counterfeit medicinal product	medicamento de imitación	IATE
diphenhydramine	difenhidramina	IATE
randomised trial	ensayo clínico aleatorizado	IATE
shortage	escasez	IATE
drug	droga	IATE
sulfadimidine	sulfadimidina	IATE
apparent density	densidad aparente	IATE
air separation	separación del aire	IATE
multi-centre trial	ensayo clínico multicéntrico	IATE
doxycycline	doxiciclina	IATE
diethylene triamine pentaacetic acid	DTPA	IATE
booster shot	dosis de recuerdo	IATE
azithromycin	azitromicina	IATE
therapeutic entity	principio activo	IATE
tertatolol	tertatolol	IATE
first-line therapy	tratamiento de primera línea	IATE
somatic cell therapy	terapia celular somática	IATE
synthetic route	vía de síntesis	IATE
teverelix	teverelix	IATE
sulocarbilate	sulocarbilato	IATE
market protection	protección de la comercialización	IATE
critical shortage in the Member State	escasez crítica en el Estado miembro	IATE
interventional study	estudio de intervención	IATE
tiotixene	tiotixeno	IATE
antigen-presenting cell	CPA	IATE
co-resistance	corresistencia	IATE
individual case safety report	Informe de seguridad de caso individual	IATE
SPC	certificado complementario de protección	IATE
thiopropazate	tiopropazato	IATE
AIMD	producto sanitario implantable activo	IATE
cumulative patient exposure	exposición acumulada del paciente	IATE
detoxified vaccine	toxoide	IATE
recombinant vaccine	vacuna recombinante	IATE
indication	indicación	IATE
sulfabenzamide	sulfabenzamida	IATE
presentation	presentación	IATE
talsupram	talsupram	IATE
sulfadicramide	sulfadicramida	IATE
European Surveillance of Antibiotic Consumption	Vigilancia Europea del Consumo de Antimicrobianos	IATE
injectable	inyectable	IATE
sulfaproxyline	sulfaproxilina	IATE
reversion to virulence	reversión a la virulencia	IATE
fitness-for-purpose	aptitud para el uso	IATE
tibeglisene	tibegliseno	IATE
structured dialogue on security of medicines supply	diálogo estructurado sobre la seguridad del suministro de medicamentos.	IATE
aminoglycoside	aminoglucósido	IATE
Bolar provision	claúsula Bolar	IATE
carbapenem	carbapenemo	IATE
comparative trial	ensayo clínico comparativo	IATE
COVID-19 vaccine	vacuna contra la COVID-19	IATE
lipoprotein	lipoproteína	IATE
pragmatic trial	ensayo pragmático	IATE
tilactase	tilactasa	IATE
safety profile	perfil de seguridad	IATE
herbal tea	Tisana	IATE
open system	sistema abierto	IATE
generic substitution	sustitución por un genérico	IATE
contract acceptor	agente contratado	IATE
local anaesthetic	anestesico local	IATE
rapporteurship	labor de ponente	IATE
current failure safety device	dispositivo contra falta de corriente eléctrica	IATE
tetrofosmin	tetrofosmina	IATE
biological veterinary medicinal product	medicamento veterinario biológico	IATE
signal detection analysis	análisis de detección de señales	IATE
attenuation	atenuación	IATE
hybrid medicinal product	medicamento híbrido	IATE
type III interferon	IFN tipo III	IATE
tallimustine	talimustina	IATE
optical rotation	rotación óptica	IATE
anticoccidial drug	anticoccidiano	IATE
timonacic	timonácico	IATE
new active substance for safety cooperation	nuevo principio activo de cara a la cooperación en materia de seguridad	IATE
Plasma Master File	archivo principal sobre plasma	IATE
suronacrine	suronacrina	IATE
tixocortol	tixocortol	IATE
tetrabarbital	tetrabarbital	IATE
sulfamazone	sulfamazona	IATE
SFC	condiciones de primer defecto	IATE
tibenzate	tibenzato	IATE
sulfatolamide	sulfatolamida	IATE
tilsuprost	tilsuprost	IATE
informed consent	consentimiento informado	IATE
tricosactide	tricosactida	IATE
qualification	cualificación	IATE
Committee for Orphan Medicinal Products	Comité de medicamentos huérfanos	IATE
accompanying solvent	disolvente de reconstitución suministrado conjuntamente	IATE
elution	elución	IATE
terlipressin	terlipresina	IATE
antiparasitic	agentes antiparasítarios	IATE
application dossier	expediente de solicitud	IATE
biopharmaceutical	biofármaco	IATE
post-translational modification	modificación postraduccional	IATE
ticlopidine	ticlopidina	IATE
Modified Outerbridge Scale	escala modificada de Outerbridge	IATE
sulfamethizole	sulfametizol	IATE
multi-national clinical trial	ensayo clínico multinacional	IATE
fusion protein vaccine	vacuna de proteína de fusión	IATE
rationally designed live virus vaccine	vacuna viva de diseño racional	IATE
bio-hybrid	medicamento biohíbrido	IATE
regulatory protection	protección normativa	IATE
tioguanine	tioguanina	IATE
downstream processing	operaciones posteriores de transformación	IATE
non-scheduled substance	sustancia no catalogada	IATE
thujone	tuyona	IATE
systemic antibiotic	antibiótico sistémico	IATE
voltage-gated sodium channel	canal de Na+	IATE
protective efficacy	eficacia de la vacuna	IATE
tofetridine	tofetridina	IATE
foodborne antimicrobial resistance	resistencia a los antibióticos transmitida por los alimentos	IATE
clastogenic potential	potencial clastogénico	IATE
tiprinast	tiprinast	IATE
theodrenaline	teodrenalina	IATE
veterinary medicinal product as intended for a limited market	medicamento veterinario como destinado a un mercado limitado	IATE
thioproperazine	tioproperazina	IATE
nucleic acid vaccine	vacuna genética	IATE
European Medicines Agency	EMEA	IATE
tinidazole	tinidazol	IATE
quality development	desarrollo de calidad	IATE
toldimfos	toldimfós	IATE
AWaRe classification	clasificación AWaRe	IATE
teoprolol	teoprolol	IATE
sulmarin	sulmarina	IATE
antibacterial agent	antibacteriano	IATE
sponsor	promotor	IATE
temocapril	temocapril	IATE
bedside preparation	preparado elaborado a pie de cama	IATE
tolindate	tolindato	IATE
thihexinol methylbromide	metilbromuro de tihexinol	IATE
tiamenidine	tiamenidina	IATE
prevalence	prevalencia	IATE
medicinal product subject to medical prescription	medicamento sujeto a receta médica	IATE
wettable powder	polvo mojable	IATE
pharmacology	farmacología	IATE
tiopinac	tiopinaco	IATE
tefenperate	tefenperato	IATE
mutual recognition procedure	procedimiento de reconocimiento mutuo	IATE
timiperone	timiperona	IATE
imdevimab	imdevimab	IATE
first re-vaccination	primera revacunación	IATE
tinabinol	tinabinol	IATE
multi-national active substance	principio activo plurinacional	IATE
bacteriophage therapy	fagoterapia	IATE
concurrent validation	validación concurrente	IATE
recombinant protein-based vaccine	vacuna de proteína recombinante	IATE
air break	sifón	IATE
tiametonium iodide	yoduro de tiametonio	IATE
XTC	Adán	IATE
Standing Committee on Biocidal Products	Comité Permanente de Biocidas	IATE
sulfamoxole	sulfamoxol	IATE
temodox	temodox	IATE
pharmaceutical particular	datos farmacéuticos	IATE
stockpilling	reserva de equipos médicos	IATE
invented name	denominación de fantasía	IATE
resuscitation medicine	medicamento de reanimación	IATE
nucleoside analog	análogo nucleósido	IATE
sulfamonomethoxine	sulfamonometoxina	IATE
hybrid veterinary medicinal product	medicamento veterinario híbrido	IATE
acetylation	acetilación	IATE
multi-medicinal product package	envase multimedicamento	IATE
sulprostone	sulprostona	IATE
tiamizide	tiamizida	IATE
investigational therapeutic agent	tratamiento en fase de investigación	IATE
dosage regimen	pauta posológica	IATE
confounder-adjusted estimate	estimación ajustada a las covariables	IATE
tizabrin	tizabrina	IATE
novel antimicrobial molecule	nuevo agente antimicrobiano	IATE
tamsulosin	tamsulosina	IATE
dilution method	método de dilución	IATE
tifencillin	tifencilina	IATE
risk-based approach to change	cambio basado en el riesgo	IATE
temelastine	temelastina	IATE
medical products	producto médico	IATE
tiropramide	tiropramida	IATE
excipient	excipiente	IATE
tipredane	tipredano	IATE
food-producing target species	especie objetivo destinada a la producción de alimentos	IATE
off-label prescribing	prescripción fuera de la indicación autorizada	IATE
MoA	modo de acción	IATE
sulfaguanidine	sulfaguanidina	IATE
chenodeoxycholic acid	ácido quenodesoxicólico	IATE
chemical-unlike biological substance	sustancia de origen biológico no análoga a una sustancia química	IATE
immunomodulatory	inmunomodulatorio	IATE
functional excipient	excipiente funcional	IATE
oestrogenic hormone	estrógeno	IATE
data concerning health	datos relativos a la salud	IATE
maceration	maceración	IATE
tirapazamine	tirapazamina	IATE
taloximine	taloximina	IATE
PICO framework	marco PICR	IATE
dechallenge	retirada del fármaco sospechoso	IATE
vial	Vial	IATE
ATMP	medicamento de terapia avanzada	IATE
(Q)SAR	relaciones cuantitativas estructura-actividad	IATE
tisopurine	tisopurina	IATE
potency	potencia	IATE
tapped density	densidad de compactación	IATE
tolazoline	tolazolina	IATE
pharmacological effect	efecto farmacológico	IATE
immunotoxic effect	efecto inmunotóxico	IATE
pleasure system	núcleo accumbens	IATE
off-label medicine	medicamento utilizado para una indicación no autorizada	IATE
sulforidazine	sulforidazina	IATE
non-intervention study	estudio no intervencional	IATE
tefludazine	tefludazina	IATE
anti-infective agent	antiinfeccioso	IATE
dose-effect curve	curva dosis-efecto	IATE
tioctilate	tioctilato	IATE
MDSSG	Grupo Director Ejecutivo sobre Productos Sanitarios	IATE
EA	agente extraño	IATE
thiotepa	tiotepa	IATE
tamitinol	tamitinol	IATE
production scale batch	lote a escala industrial	IATE
sulfachlorpyridazine	sulfaclorpiridazina	IATE
IPV	vacuna antipoliomielítica inactivada	IATE
electronic product information	información electrónica de los productos	IATE
synergistic effect	efecto sinérgico	IATE
INN	DCI	IATE
homeopathic medicinal product	medicamento homeopático	IATE
sulfomyxin	sulfomixina	IATE
post-marketing authorisation application	solicitud de autorización posterior a la comercialización	IATE
tibenelast	tibenelast	IATE
dexamethasone	dexametasona	IATE
commensal bacterium	bacteria comensal	IATE
Vulnerabilities of the global supply chains of medicines	vulnerabilidades de las cadenas mundiales de suministro de medicamentos	IATE
tolnaftate	tolnaftato	IATE
endotoxin	endotoxina	IATE
tixanox	tixanox	IATE
viral removal	supresión viral	IATE
phenylacetic acid	ácido fenilacético	IATE
particle size	tamaño de partícula	IATE
teroxirone	teroxirona	IATE
toxic effect	efectos tóxicos	IATE
rejected material	material rechazado	IATE
rejected veterinary medicinal product	medicamento veterinario rechazado	IATE
tibezonium iodide	yoduro de tibezonio	IATE
NTID	fármaco con índice terapéutico estrecho	IATE
falsified active substance	principio activo falsificado	IATE
temefos	temefós	IATE
EU action plan on AMR	Plan de Acción europeo «Una sola salud» para luchar contra la resistencia a los antimicrobianos	IATE
sultiame	sultiamo	IATE
batch	lote	IATE
antimicrobial prophylaxis	profilaxis antibiótica	IATE
generic	EFG	IATE
Animal and Plant Health Inspection Service	Servicio de inspección sanitaria animal y fitosanitaria	IATE
tienocarbine	tienocarbina	IATE
conjugate vaccine	vacuna conjugada	IATE
intradermal	intradérmico	IATE
sulfanitran	sulfanitrán	IATE
autoclave	autoclave	IATE
MDR pathogen	organismo multirresistente	IATE
safety pharmacology	farmacología de seguridad	IATE
tyrothricin	tirotricina	IATE
talniflumate	talniflumato	IATE
tilozepine	tilozepina	IATE
serious adverse event	acontecimiento adverso grave	IATE
protocol	protocolo	IATE
AE	acontecimiento adverso	IATE
sulosemide	sulosemida	IATE
immediate-release oral formulation	forma farmacéutica oral de liberación inmediata	IATE
methylprednisolone	metilprednisolona	IATE
primary vaccination course	primovacunación	IATE
thymopentin	timopentina	IATE
tiabendazole	tiabendazol	IATE
taprostene	taprosteno	IATE
systemic antimicrobial drug	agente antimicrobiano sistémico	IATE
adaptive immunity	inmunidad adquirida	IATE
very low-density lipoprotein	VLDL	IATE
fibrinolysis	fibrinólisis	IATE
serious adverse event	efecto secundario grave	IATE
biomolecule	biomolécula	IATE
impurity	impureza	IATE
sulfadiasulfone sodium	sulfadiasulfona sódica	IATE
FSCA	acción correctiva de seguridad	IATE
budesonide	budesonida	IATE
taurolidine	taurolidina	IATE
stable derivate of human blood	derivado estable de la sangre	IATE
isolated intermediate	sustancia intermedia aislada	IATE
manufacturing authorisation	autorización de fabricación	IATE
MDP2P	3,4-metilenodioxifenilpropano-2-ona	IATE
transferable exclusivity voucher	bono transferible de exclusividad de datos	IATE
therapeutic class	categoría terapéutica	IATE
VeDDRA	VeDDRA	IATE
OOC	órgano en chip	IATE
dispensing pharmacy	farmacia abierta al público	IATE
Extended EudraVigilance Medicinal Product Dictionary	xEVMPD	IATE
common technical document	documento técnico común	IATE
residue depletion study	estudio de eliminación de residuos	IATE
structural elucidation	elucidación de la estructura	IATE
pharmacoepidemiology	farmacoepidemiología	IATE
computational drug design	diseño de fármacos con ordenador	IATE
referral procedure	procedimiento de arbitraje	IATE
sulfathiourea	sulfatiourea	IATE
bacteriocin	bacteriocinogénico	IATE
IVD	producto destinado al diagnóstico in vitro	IATE
intramammary	intramamario	IATE
cone mill	molino de conos	IATE
bulk change	cambio masivo	IATE
coccidiostat	coccidiostato	IATE
top three priority health threats	tres mayores amenazas sanitarias	IATE
traditional herbal medicinal product	medicamento tradicional a base de plantas	IATE
drug	opciones terapéuticas	IATE
Good Laboratory Practice inspection	inspección de buenas prácticas de laboratorio	IATE
tocofenoxate	tocofenoxato	IATE
thapsigargin	tapsigargina	IATE
cephalosporin	cefalosporina	IATE
residual moisture	humedad residual	IATE
tebatizole	tebatizol	IATE
theophylline ephedrine	teofilina efedrina	IATE
sulfisomidine	sulfisomidina	IATE
cumulative summary tabulation	cuadro resumen de exposiciones acumuladas	IATE
LOA	carta de acceso	IATE
pharmacovigilance system master file	archivo maestro del sistema de farmacovigilancia	IATE
variation	modificación de la autorización de comercialización	IATE
antimicrobial medicinal product	sustancia antimicrobiana	IATE
master seed lot	cepa madre	IATE
phototype	fototipo	IATE
suricainide	suricainida	IATE
tolpentamide	tolpentamida	IATE
suproclone	suproclona	IATE
potassium permanganate	permanganato potásico	IATE
method of manufacture	método de fabricación	IATE
sulmazole	sulmazol	IATE
non-interventional PASS	estudio de seguridad no intervencional posterior a la autorización	IATE
tiadenol	tiadenol	IATE
pilot scale batch	lote a escala piloto	IATE
sotrovimab	sotrovimab	IATE
perioperative prophylaxis	profilaxis antimicrobiana perioperatoria	IATE
chondrocyte	condrocito	IATE
wettability	mojabilidad	IATE
manufacturing effluent	efluente industrial	IATE
MLV vaccine	vacuna de virus vivo modificado	IATE
sulfasymazine	sulfasimazina	IATE
thiamazole	tiamazol	IATE
designer precursor	precursor de diseño	IATE
tiludronic acid	ácido tiludrónico	IATE
Coordination Group for Mutual Recognition and Decentralised Procedures - Human	Grupo de Coordinación de los Procedimientos de Reconocimiento Mutuo y Descentralizados– Medicamentos humanos	IATE
biological indicator	bioindicador	IATE
suprofen	suprofeno	IATE
sulfadoxine	sulfadoxina	IATE
hypertonicity	hipertonía	IATE
ampoule	ampolla	IATE
tolciclate	tolciclato	IATE
gene therapy medicinal product	medicamento de terapia génica	IATE
tiazuril	tiazurilo	IATE
antimicrobial activity	actividad antimicrobiana	IATE
bedside testing	pruebas realizadas cerca del paciente	IATE
talbutal	talbutal	IATE
chemical-like biological substance	sustancia de origen biológico análoga a una sustancia química	IATE
tixadil	tixadil	IATE
tinazoline	tinazolina	IATE
repeated-dose toxicity	toxicidad por administración repetida	IATE
contraindication	contraindicación	IATE
healthcare worker	profesional de los servicios sanitarios	IATE
immunogenicity	inmunogenicidad	IATE
qualitative composition	composición cualitativa	IATE
post-authorisation safety study	estudio de seguridad posterior a la autorización	IATE
observational study	estudio observacional	IATE
timolol	timolol	IATE
tienoxolol	tienoxolol	IATE
ESBL	betalactamasa de espectro ampliado	IATE
product quality review	revisión de la calidad del producto	IATE
translational research	investigación aplicada	IATE
SERM	modulador selectivo de receptores de estrogenos	IATE
acetylcholinesterase	acetilcolinesterasa	IATE
ticarbodine	ticarbodina	IATE
enzyme inhibition	inhibición enzimática	IATE
combined advanced therapy medicinal product	medicamento combinado de terapia avanzada	IATE
tipetropium bromide	bromuro de tipetropio	IATE
tianafac	tianafaco	IATE
telinavir	telinavir	IATE
vaccine	vacuna	IATE
non-competitive inhibition	inhibición no competitiva	IATE
suloxifen	suloxifeno	IATE
distribution constant	coeficiente de distribución	IATE
ticarcillin	ticarcilina	IATE
International Cooperation on Harmonisation of Technical Requirements for Registration of Veterinary Medicinal Products	VICH	IATE
protease inhibitor	inhibidor de la proteasa	IATE
ETF	Grupo de Trabajo sobre Emergencias	IATE
cholinoceptor	receptor colinérgico	IATE
talsaclidine	talsaclidina	IATE
antiprotozoal	antiprotozoico	IATE
vaccine platform technology	tecnología de plataforma vacunal	IATE
hypotonicity	hipotonía	IATE
Good Clinical Practice inspection	inspección de buenas prácticas clínicas	IATE
tidiacic	tidiácico	IATE
patented medicine	medicamento patentado	IATE
tiazesim	tiazesima	IATE
essentially similar product	medicamento esencialmente similar	IATE
thiotetrabarbital	tiotetrabarbital	IATE
tolmesoxide	tolmesóxido	IATE
drug-resistant organism	microorganismo resistente	IATE
thymalfasin	timalfasina	IATE
tisocromide	tisocromida	IATE
thiocolchicoside	tiocolchicósido	IATE
tenilsetam	tenilsetam	IATE
solution for infusion	solución para infusión intravenosa	IATE
unitary certificate	certificado complementario de protección unitario	IATE
falsified medicine	medicamento falsificado	IATE
hydroxychloroquine	hidroxicloroquina	IATE
sulnidazole	sulnidazol	IATE
potency test	control de actividad	IATE
CAR T cell therapy	terapia de células T con receptor de antígeno quimérico	IATE
tilomisole	tilomisol	IATE
chargeable unit	unidad imputable	IATE
Community Register of Medicinal Products	Registro de la Unión	IATE
wetting agent	producto humectante	IATE
medical countermeasure	contramedida médica	IATE
bioequivalence	bioequivalencia	IATE
tioconazole	tioconazol	IATE
antimicrobial resistance determinant	determinante de resistencia a los antimicrobianos	IATE
fluid bed dryer	secador de lecho fluidizado	IATE
fee	tasa	IATE
tocofersolan	tocofersolán	IATE
SAR	SAR	IATE
terazosin	terazosina	IATE
controlled clinical trial	estudio clínico controlado	IATE
overdose	sobredosis	IATE
antibiotic	antibiótico	IATE
prospective validation	validación prospectiva	IATE
post-authorisation phase	fase posterior a la autorización	IATE
sulukast	sulukast	IATE
equivalence	equivalencia	IATE
pseudoephedrine	pseudoefedrina	IATE
food-producing animal species	animal productor de alimentos	IATE
drug metabolism	metabolismo	IATE
herbal medicinal substance	producto vegetal	IATE
adaptive trial	ensayo clínico con diseño de adaptación	IATE
tioxacin	tioxacino	IATE
pull incentive	incentivo de compensación	IATE
principal investigator	investigador principal	IATE
bucket trial	ensayo de tipo cesta	IATE
tiapirinol	tiapirinol	IATE
tiapamil	tiapamilo	IATE
timelotem	timelotem	IATE
tofisopam	tofisopam	IATE
tiprenolol	tiprenolol	IATE
thiohexamide	tiohexamida	IATE
process validation	validación del proceso	IATE
unqualified impurity	impureza no cualificada	IATE
psychoactive drug	sustancia psicoactiva	IATE
outer package	embalaje exterior	IATE
generic veterinary medicinal product	medicamento veterinario genérico	IATE
SPC for medicinal products	certificado complementario de protección para los medicamentos	IATE
risk management plan	plan de gestión de riesgos	IATE
tifemoxone	tifemoxona	IATE
active principle of biological origin	sustancia biológica	IATE
common name	denominación común	IATE
binding site	sitio de unión	IATE
docusate sodium	docusato sódico	IATE
pharmacological property	propiedad farmacológica	IATE
concrete	aceite esencial concreto	IATE
thiamphenicol	tianfenicol	IATE
awareness card	tarjeta de sensibilización	IATE
safety assessing Member State	Estado miembro encargado de evaluar la seguridad	IATE
European Public Assessment Report	Informe Público Europeo de Evaluación	IATE
potentisation	dinamización	IATE
AmpC beta-lactamase	betalactamasa tipo AmpC	IATE
sultopride	sultoprida	IATE
lanolin	lanolina	IATE
excursion	desviación	IATE
hospital pharmacy	farmacia hospitalaria	IATE
sulfaperin	sulfaperina	IATE
marker vaccine	vacuna marcadora	IATE
thiethylperazine	tietilperazina	IATE
user safety	seguridad para el usuario	IATE
serious adverse reaction	reacción adversa grave	IATE
medicinal product for human use	medicamento de uso humano	IATE
screening of suspected unexpected serious adverse reactions	control de sospechas de reacciones adversas graves e inesperadas	IATE
essential oil	aceite esencial	IATE
randomisation	aleatorización	IATE
major epizootic disease	epizootia grave	IATE
sulmepride	sulmeprida	IATE
quantitative composition	composición cuantitativa	IATE
clinical study	estudio clínico	IATE
thiopental sodium	tiopental sódico	IATE
glycoprotein E-deleted vaccine	vacuna de deleción de la glucoproteína E	IATE
tiapride	tiaprida	IATE
epithelial cell	célula epitelial	IATE
timirdine	timirdina	IATE
MRL	LMR	IATE
thioacetazone	tioacetazona	IATE
susalimod	susalimod	IATE
live vaccinal strain	cepa vacunal atenuada	IATE
AMR	resistencia a los antimicrobianos	IATE
chargeable unit-human	unidad de uso humano imputable	IATE
expiration date	fecha de caducidad	IATE
monoclonal antibody	anticuerpo monoclonal	IATE
sulfabenz	sulfabenzo	IATE
femoral condyle	cóndilo femoral	IATE
priority antimicrobial	antimicrobiano prioritario	IATE
tetroxoprim	tetroxoprima	IATE
gentamicin	gentamicina	IATE
investigational device	producto en investigación	IATE
dosage unit	dosis	IATE
dropout	baja	IATE
intermediate	producto intermedio	IATE
tiacrilast	tiacrilast	IATE
blood-brain barrier	barrera hematoencefálica	IATE
thiambutosine	tiambutosina	IATE
rejected active substance	principio activo rechazado	IATE
standard volumetric solution	solución volumétrica	IATE
reconstitution	reconstitución	IATE
sutilains	sutilaína	IATE
bacteriostatic agent	bacteriostático	IATE
tumourigenic potential	potencial tumorigénico	IATE
xenogeneic	xenogénico	IATE
Collaboration Agreement of Drug Regulatory Authorities in European Union Associated Countries	CADREAC	IATE
sulfacitine	sulfacitina	IATE
milestone prize	prima por hito	IATE
tocofibrate	tocofibrato	IATE
formulated product	preparado farmacéutico	IATE
sulfaclomide	sulfaclomida	IATE
tasuldine	tasuldina	IATE
efficacy end-point	variable de eficacia	IATE
sulfamide	sulfamida	IATE
tiaprost	tiaprost	IATE
3Rs	3R	IATE
tererstigmine	tererstigmina	IATE
human equivalent dose	dosis equivalente en humanos	IATE
hexahydropyridine	piperidina	IATE
sulfatroxazole	sulfatroxazol	IATE
ticolubant	ticolubant	IATE
phage type	tipo bacteriófago	IATE
statement of dose	posología	IATE
tolpiprazole	tolpiprazol	IATE
advanced therapy medicinal product prepared under hospital exemption	medicamento de terapia avanzada preparado al amparo de una excepción hospitalaria	IATE
double-dummy design	diseño de doble simulación	IATE
autovaccine	autovacuna	IATE
immunostimulation	inmunoestimulación	IATE
use patent	patente de uso	IATE
suriclone	suriclona	IATE
coccidiocide	coccidicida	IATE
suplatast tosilate	tosilato de suplatast	IATE
univalent vaccine	vacuna monovalente	IATE
Good Manufacturing Practice inspection	inspección de buenas prácticas de fabricación	IATE
ACh	acetilcolina	IATE
anticoagulant	anticoagulante	IATE
divekacin	dibekacina	IATE
entity not engaged in an economic activity	entidad que no ejerce una actividad económica	IATE
ethyl 6-(decyloxy)-7-ethoxy-4-hydroxy-3-quinoline-carboxylate	decoquinato	IATE
tipindole	tipindol	IATE
tandospirone	tandospirona	IATE
toloxatone	toloxatona	IATE
radionuclide precursor	precursor de radionucleidos	IATE
corrective and preventive actions	medidas correctivas y preventivas	IATE
allogeneic	alógeno	IATE
critical medicinal product	medicamento crítico	IATE
sumacetamol	sumacetamol	IATE
non-homologous use	uso no homólogo	IATE
preclinical test	ensayo preclínico	IATE
active substance master file certificate	certificado del archivo maestro de la sustancia activa	IATE
progestogen	gestágeno	IATE
non-isolated intermediate	sustancia intermedia no aislada	IATE
tigloidine	tigloidina	IATE
tolperisone	tolperisona	IATE
bactericide	bactericida	IATE
sulfaguanole	sulfaguanol	IATE
immunotoxicity	inmunotoxicidad	IATE
estimate	estimación	IATE
LVP solution	parenteral de gran volumen	IATE
sulpiride	sulpirida	IATE
methicillin-resistant Staphylococcus	estafilococo resistente a la meticilina	IATE
antimicrobial stewardship	gestión de los antimicrobianos	IATE
tepoxalin	tepoxalina	IATE
tesimide	tesimida	IATE
precision medicine	medicina de precisión	IATE
emulsifiability	poder emulsionante	IATE
antagonism	antagonismo	IATE
terbequinil	terbequinilo	IATE
suxibuzone	suxibuzona	IATE
IMP	MI	IATE
tifenamil	tifenamilo	IATE
European Database on drug precursors	Base de Datos Europea sobre Precursores de Drogas	IATE
sunset clause	"cláusula ""sunset"""	IATE
cosmetic product	producto cosmético	IATE
notification of parallel distribution	notificación de distribución paralela	IATE
TLR	TLR	IATE
control group	grupo de control	IATE
returned veterinary medicinal product	medicamento veterinario devuelto	IATE
unadjusted estimate	estimación sin ajustar	IATE
homologous use	uso homólogo	IATE
tendamistat	tendamistat	IATE
teniposide	tenipósido	IATE
anticholinesterase activity	actividad anticolinesterásica	IATE
tazarotene	tazaroteno	IATE
vPTMF	archivo maestro de tecnología de plataforma vacunal	IATE
epidemiological cut-off value	valor de corte epidemiológico	IATE
endpoint	criterio de valoración	IATE
transmembrane receptor	receptor de la superficie de la célula	IATE
orphan medicine sponsor	promotor de medicamentos huérfanos	IATE
tazasubrate	tazasubrato	IATE
on-label use	uso autorizado	IATE
free sale of remedies	venta libre de medicamentos	IATE
route of administration	vía de administración	IATE
timofibrate	timofibrato	IATE
teicoplanin	teicoplanina	IATE
antibiotic synergism	sinergismo antibiótico	IATE
magistral formula	fórmula magistral	IATE
expression vector	vector de expresión	IATE
full-thickness cartilage defect	lesión que afecta al espesor total del cartílago	IATE
active substance starting material	material de partida	IATE
absolute	quintaesencia	IATE
falsified active substance used as a starting material in veterinary medicinal products	principio activo falsificado utilizado como material de partida en medicamentos veterinarios	IATE
uncompetitive inhibition	inhibición acompetitiva	IATE
excretion	excreción	IATE
patient package insert	prospecto	IATE
systematic review	revisión sistemática	IATE
EUAL procedure	procedimiento de la EUL	IATE
safety concern in relation to an investigational medicinal product	problema de seguridad relativo a un medicamento en investigación	IATE
taurultam	taurultam	IATE
adverse effect	efecto adverso	IATE
sulfaclorazole	sulfaclorazol	IATE
DCP	procedimiento de autorización descentralizado	IATE
LMWH	heparina de bajo peso molecular	IATE
supplemental assay	análisis complementario	IATE
tipepidine	tipepidina	IATE
medicinal product of common interest	medicamento de interés común	IATE
time-effect curve	curva tiempo-efecto	IATE
potency bioassay	bioensayo de potencia	IATE
spectinomycin	espectinomicina	IATE
tauromustine	tauromustina	IATE
holding	conservación	IATE
tiprostanide	tiprostanida	IATE
thialbarbital	tialbarbital	IATE
tetracycline	tetraciclina	IATE
sulfarsphenamine	sulfarsfenamina	IATE
extraction solvent	solvente de extracción	IATE
teopranitol	teopranitol	IATE
EU Global Health Strategy	Estrategia de la Unión Europea en materia de Salud	IATE
tobicillin	tobicillina	IATE
hydrate	hidrato	IATE
tetridamine	tetridamina	IATE
tinzaparin sodium	tinzaparina sódica	IATE
signal detection	detección de señales	IATE
depletion	depleción	IATE
Committee for Advanced Therapies	Comité de Terapias Avanzadas	IATE
read-across approach	extrapolación	IATE
resistance	resistencia microbiana	IATE
sulfachrysoidine	sulfacrisoidina	IATE
dosing device	dispositivo dosificador	IATE
intrinsic resistance	resistencia intrínseca a los antimicrobianos	IATE
taltrimide	taltrimida	IATE
market entry reward	recompensa a la entrada en el mercado como cuantía a tanto alzado	IATE
tiliquinol	tiliquinol	IATE
single agent PSUR	informe periódico de seguridad sobre un solo principio activo	IATE
European Federation of Pharmaceutical Industries and Associations	EFPIA	IATE
nuclear radiation	radiación nuclear	IATE
tolazamide	tolazamida	IATE
endocrine disruption	perturbación endocrina	IATE
EVMPD medicinal product dictionary	EVMPD	IATE
tylosin	tilosina	IATE
tazanolast	tazanolast	IATE
telimomab aritox	telimomab aritox	IATE
Member States’ cross-border procurement	contratación transfronteriza de los Estados miembros	IATE
overconsumption	uso excesivo de un medicamento	IATE
tinisulpride	tinisulprida	IATE
tenosiprol	tenosiprol	IATE
selective medium	medio selectivo	IATE
talampicillin	talampicilina	IATE
pyrithione zinc	piritiona cíncica	IATE
ATC code	código ATC	IATE
allergen	alergeno	IATE
CTIS	sistema de información sobre los ensayos clínicos	IATE
tetronasin	tetronasina	IATE
sumatriptan	sumatriptán	IATE
co-developed companion diagnostic	prueba diagnóstica para selección terapéutica codesarrollada	IATE
controlled substance	sustancia controlada	IATE
Δ9-THC	THC	IATE
blister pack	blíster	IATE
voluntary post-marketing surveillance study	estudio voluntario de supervisión posterior a la comercialización	IATE
over-the-counter drug	medicamento de venta libre	IATE
lipoprotein lipase	lipoproteína lipasa	IATE
cumulative subject exposure	exposición acumulada de un individuo	IATE
personalised medicinal product	medicamento personalizado	IATE
immunisation	inmunización activa	IATE
temozolomide	temozolomida	IATE
prostate cancer	cáncer de próstata	IATE
tizanidine	tizanidina	IATE
sulfamerazine sodium	sulfamerazina sódica	IATE
clinical pharmacology	farmacología clínica	IATE
reporting Member State	Estado miembro notificante	IATE
tioxamast	tioxamast	IATE
adverse event	acontecimiento adverso	IATE
RWE	datos de la vida real	IATE
GCP	buenas prácticas clínicas	IATE
reference medicine	medicamento de referencia	IATE
diluent	diluyente	IATE
ampicillin	ampicilina	IATE
tirilazad	tirilazad	IATE
tetramisole	tetramisol	IATE
Paediatric Committee	Comité pediátrico	IATE
cumulative action	efecto acumulativo	IATE
off-target interference	interferencia no intencionada	IATE
quinolone	quinolona	IATE
platform trial	ensayo de plataforma	IATE
repurposed medicine	medicamento readaptado	IATE
requested post-marketing surveillance study	estudio solicitado de supervisión posterior a la comercialización	IATE
FSN	nota de seguridad	IATE
tameticillin	tameticilina	IATE
protective equipment	equipo de protección individual	IATE
sulfapyridine	sulfapiridina	IATE
decontamination	descontaminación	IATE
enteric-coated tablet	Comprimido gastrorresistente	IATE
tiemonium iodide	yoduro de tiemonio	IATE
talmetoprim	talmetoprima	IATE
ASMF	archivo maestro del principio activo	IATE
casirivimab	casirivimab	IATE
tilisolol	tilisolol	IATE
taglutimide	taglutimida	IATE
mutual recognition	reconocimiento mutuo	IATE
pharmaceutical dose form	forma galénica	IATE
sulfasuccinamide	sulfasuccinamida	IATE
taziprinone	taziprinona	IATE
export certificates for centrally-authorised medicinal products	certificado de exportación de medicamentos autorizados por el procedimiento centralizado	IATE
contained system	sistema contenido	IATE
tenonitrozole	tenonitrozol	IATE
bone marrow	médula ósea	IATE
substances generally recognised as safe	sustancias generalmente consideradas inocuas	IATE
acute overdosage	sobredosis aguda	IATE
pharmaceutical test	prueba farmacéutica	IATE
telmesteine	telmesteína	IATE
monoterpene	monoterpeno	IATE
tolpronine	tolpronina	IATE
stability study	estudio de estabilidad	IATE
pharmacovigilance system	sistema de farmacovigilancia	IATE
European Group on Ethics in Science and New Technologies	GEE	IATE
thiacetarsamide sodium	tiacetarsamida sódica	IATE
amikacin	amikacina	IATE
tilbroquinol	tilbroquinol	IATE
sumarotene	sumaroteno	IATE
antimicrobial susceptibility test	antibiograma	IATE
kanamycin	kanamicina	IATE
self-medication	automedicacion	IATE
terdecamycin	terdecamicina	IATE
opioid	analgésico opioide	IATE
vigilance	vigilancia	IATE
sulfaethidole	sulfaetidol	IATE
tizolemide	tizolemida	IATE
i-SPOC system	red de puntos de contacto únicos de la industria	IATE
galantamine	galantamina	IATE
sulfacecole	sulfacecol	IATE
tigestol	tigestol	IATE
PRAC	Comité Consultivo para la Determinación del Riesgo en Farmacovigilancia	IATE
tolonium chloride	cloruro de tolonio	IATE
disintegration time	tiempo de desintegración	IATE
suritozole	suritozol	IATE
IB	manual del investigador	IATE
thiazosulfone	tiazosulfona	IATE
tinoridine	tinoridina	IATE
taniplon	taniplona	IATE
plasma concentration-time curve	ABC	IATE
carcinogenic potential	potencial carcinógeno	IATE
pre-clinical development	desarrollo no clínico	IATE
distribution	distribución	IATE
sulfacarbamide	sulfacarbamida	IATE
antigen	antígeno	IATE
pharmaceutical preparation	preparado	IATE
stem cell	célula troncal	IATE
suxemerid	suxemerid	IATE
tolerance	tolerabilidad	IATE
CMR	carcinógeno, mutágeno o tóxico para la reproducción	IATE
supidimide	supidimida	IATE
thymocartin	timocartina	IATE
similar biological medicinal product	medicamento biológico similar	IATE
sulindac	sulindaco	IATE
β-lactamase	betalactamasa	IATE
adaptive antimicrobial resistance	resistencia adaptativa a los antimicrobianos	IATE
additional quality master file	archivo maestro de calidad adicional	IATE
new potentially causal association	nueva asociación potencialmente causal	IATE
temocillin	temocilina	IATE
SoHO-derived medicinal product other than ATMPs	medicamento derivado de SoHO distinto de los medicamentos de terapia avanzada	IATE
active pharmaceutical ingredient	IFA	IATE
peginterferon lambda-1a	interferón pegilado lambda	IATE
campaigned manufacture	fabricación por campañas	IATE
tifacogin	tifacogina	IATE
therapeutic effect	efecto terapéutico	IATE
tiopronin	tiopronina	IATE
tioxaprofen	tioxaprofeno	IATE
tenoxicam	tenoxicam	IATE
repurposing	nuevas indicaciones de fármacos	IATE
active substance gas	sustancia activa gaseosa	IATE
marketing authorisation under exceptional circumstances	autorización de comercialización en circunstancias excepcionales	IATE
tiosalan	tiosalán	IATE
Anatomical Therapeutic Chemical classification system	Código ATC	IATE
temocaprilat	temocaprilato	IATE
prednisone	prednisona	IATE
tiodonium chloride	cloruro de tiodonio	IATE
whole inactivated vaccine	vacuna de virus entero inactivado	IATE
tiodazosin	tiodazosina	IATE
symclosene	sincloseno	IATE
sulfaphenazole	sulfafenazol	IATE
marketing authorisation application	solicitud de autorización de comercialización	IATE
future-proof	con perspectivas de futuro	IATE
somatic cell therapy medicinal product	medicamento de terapia celular somática	IATE
self-inspection	autoinspección	IATE
protection period	período de protección	IATE
S-protein COVID-19 antigen	antígeno COVID-19 de proteína S	IATE
tolamolol	tolamolol	IATE
tigemonam	tigemonam	IATE
talmetacin	talmetacina	IATE
Eudamed	Eudamed	IATE
surfomer	surfómero	IATE
AER	comunicación de acontecimientos adversos	IATE
product information	Información sobre el producto (RCP, etiquetado y prospecto)	IATE
bedside manufacturing	fabricación «de cabecera»	IATE
clinical assessment	evaluación clínica	IATE
ticlatone	ticlatona	IATE
molnupiravir	molnupiravir	IATE
procedure pack	equipo de procedimientos	IATE
tazomeline	tazomelina	IATE
ePrescription	receta electrónica	IATE
shelf life	período de validez	IATE
comparator medicine	comparador	IATE
field trial	ensayo clínico de campo	IATE
tazifylline	tazifilina	IATE
customer complaint	reclamación	IATE
teludipine	teludipino	IATE
menadione sodium bisulphite	bisulfito sódico de menadiona	IATE
Medical Device Coordination Group	Grupo de Coordinación de Productos Sanitarios	IATE
error catastrophe	catástrofe de error	IATE
analytical method	método analítico	IATE
single symptomatic cartilage defect	lesión sintomática única del cartílago	IATE
orphan medicinal product for human use	medicamento huérfano de uso humano	IATE
rolling review	revisión continua	IATE
talastine	talastina	IATE
sulfamerazine	sulfamerazina	IATE
tisoquone	tisocuona	IATE
tacrine	tacrina	IATE
sulfadimethoxine	sulfadimetoxina	IATE
medicine development	desarrollo de medicamentos	IATE
prescriber	persona que extiende la receta	IATE
crisis-resilient system	sistema a prueba de crisis	IATE
buffer stock	existencias de seguridad	IATE
procuring	adquisición	IATE
radionuclide generator	generador de radionucleidos	IATE
tiquinamide	tiquinamida	IATE
medicinal gas	gas medicinal	IATE
tolfamide	tolfamida	IATE
agonist	agonista	IATE
clinical development	desarrollo clínico	IATE
tenocyclidine	tenociclidina	IATE
absorption	absorción sistémica	IATE
inactivation	inactivación	IATE
CM	producción continua	IATE
tameridone	tameridona	IATE
amantadine	amantadina	IATE
thiazinamium metilsulfate	metilsulfato de tiazinamio	IATE
product recall	recuperación de un producto	IATE
sample container	recipiente para muestras	IATE
interval patient exposure	intervalo de exposición del paciente	IATE
tipropidil	tipropidil	IATE
tissue engineering	ingeniería tisular	IATE
tiletamine	tiletamina	IATE
antimicrobial of last resort	antimicrobiano de último recurso	IATE
tobramycin	tobramicina	IATE
tiquizium bromide	bromuro de tiquizio	IATE
One Health Joint Plan of Action	Plan de Acción Conjunto «Una sola salud»	IATE
GH EDCTP3 JU	Empresa Común EDCTP 3	IATE
umbrella trial	ensayo de paraguas	IATE
sulfinpyrazone	sulfinpirazona	IATE
tazadolene	tazadoleno	IATE
sulofenur	sulofenur	IATE
talisomycin	talisomicina	IATE
in vitro companion diagnostic device	pruebas diagnósticas con fines terapéuticos	IATE
adjuvant	adyuvante	IATE
psychotropic drug	sustancia psicotrópica	IATE
tiflorex	tiflorex	IATE
tiomergine	tiomergina	IATE
sulfaclozine	sulfaclozina	IATE
protein-based vaccine	vacuna proteínica	IATE
tacrolimus	tacrolimús	IATE
talipexole	talipexol	IATE
thenalidine	tenalidina	IATE
initial marketing authorisation application	solicitud de autorización de comercialización inicial	IATE
monensin	monensina sódica	IATE
Pharmaceutical Committee	Comité Farmacéutico	IATE
taltirelin	taltirelina	IATE
intended purpose	finalidad prevista	IATE
risk management system	sistema de gestión de riesgos	IATE
tedisamil	tedisamil	IATE
tiamiprine	tiamiprina	IATE
tamolarizine	tamolarizina	IATE
storage	almacenamiento	IATE
batch release	liberación del lote	IATE
syrosingopine	sirosingopina	IATE
off-target insertion	inserción no intencionada	IATE
Union marketing authorisation	autorización de comercialización comunitaria	IATE
timefurone	timefurona	IATE
container-closure system	sistema de cierre del envase	IATE
scaffold	soporte	IATE
friability	friabilidad	IATE
EU clinical trial portal	portal de ensayos clínicos de la UE	IATE
perpetual platform trial	ensayo de plataforma perpetua	IATE
crystalline state	estructura cristalina	IATE
major type-II variation	modificación de importancia mayor de tipo II	IATE
off-target change	modificación no intencionada	IATE
terbucromil	terbucromilo	IATE
contract giver	agente contratante	IATE
temurtide	temurtida	IATE
food supplement	complemento alimenticio	IATE
thyroglobulin	tiroglobulina	IATE
HTA	evaluación de las tecnologías sanitarias	IATE
AMR medical countermeasure	contramedida para la RAM	IATE
toborinone	toborinona	IATE
sultamicillin	sultamicilina	IATE
retention time	tiempo de retención	IATE
terpene	terpeno	IATE
tiomesterone	tiomesterona	IATE
drug-target protein	proteína diana del medicamento	IATE
eluate	eluato	IATE
tiagabine	tiagabina	IATE
teprotide	teprotida	IATE
late-stage clinical development	desarrollo clínico en fase avanzada	IATE
exposure-response relationship	relación exposición-efecto	IATE
medicated feedingstuff	pienso medicado	IATE
tasonermin	tasonermina	IATE
CVMP	Comité de medicamentos de uso veterinario	IATE
Committee on Herbal Medicinal Products	Comité de Medicamentos a base de Plantas	IATE
EU FAB	red de capacidades de producción preparadas para la fabricación de vacunas y productos terapéuticos	IATE
terikalant	terikalant	IATE
botanical preparation	preparado a base de plantas	IATE
conditional marketing authorisation	autorización condicional de comercialización	IATE
thioridazine	tioridazina	IATE
temporary emergency marketing authorisation	autorización temporal de comercialización de emergencia	IATE
sulfiram	sulfiram	IATE
in vitro mammalian cell transformation test	ensayo de transformación de células de mamífero in vitro	IATE
tetrazepam	tetrazepam	IATE
killed vaccine	vacuna inactivada	IATE
timobesone	timobesona	IATE
robustness	robustez	IATE
synergy	sinergia	IATE
minimal bactericidal concentration	CBM	IATE
teclothiazide	teclotiazida	IATE
haemopoietic stem cell	hemocitoblasto	IATE
virulence factor	factor de virulencia	IATE
tienopramine	tienopramina	IATE
morphine	morfina	IATE
enteric coated capsule	Cápsula gastrorresistente	IATE
coordinated safety assessment	evaluación coordinada de la seguridad	IATE
terconazole	terconazol	IATE
tepirindole	tepirindol	IATE
TSC	citoblasto histoespecífico	IATE
investigator	investigador	IATE
viral vector	vector viral	IATE
chlorpromazine	clorpromacina	IATE
lead safety assessing Member State	Estado miembro principal encargado de evaluar la seguridad	IATE
thymotrinan	timotrinán	IATE
tasosartan	tasosartán	IATE
taclamine	taclamina	IATE
micronising	micronización	IATE
combined vaccine	vacuna combinada	IATE
ivermectin	ivermectina	IATE
annual pharmacovigilance fee	tasa anual de farmacovigilancia	IATE
tiflamizole	tiflamizol	IATE
terlakiren	terlakireno	IATE
relative bioavailability study	estudio de biodisponibilidad	IATE
tiaramide	tiaramida	IATE
tirofiban	tirofibán	IATE
hybridoma	hibridoma	IATE
tenilapine	tenilapina	IATE
microbiological quality	calidad microbiológica	IATE
decentralised site	sede descentralizada	IATE
colistin	colistina	IATE
causality assessment method	evaluación de la causalidad	IATE
mutagenic potential	potencia mutagénica	IATE
EU Database on Clinical Trials	base de datos de la UE sobre ensayos clínicos	IATE
tolafentrine	tolafentrina	IATE
healthcare-associated infection	infección iatrogénica	IATE
paediatric investigation plan	plan de investigación pediátrica	IATE
parallel distribution	distribución paralela	IATE
sulfinalol	sulfinalol	IATE
antifungal drug	antimicótico	IATE
serovar	serovariedad	IATE
compassionate use	uso compasivo	IATE
suspected adverse event	sospecha de acontecimiento adverso	IATE
karyology	cariología	IATE
tiqueside	tiquesida	IATE
chargeable unit-veterinary	unidad veterinaria imputable	IATE
meta-analysis	metanálisis	IATE
17α-ethynylestradiol	EE2	IATE
tenamfetamine	tenanfetamina	IATE
priority medicines scheme	PRIME	IATE
anakinra	anakinra	IATE
two-dose schedule	pauta de dos dosis	IATE
clean room	sala blanca	IATE
raloxifene	raloxifeno	IATE
virus-like particle	partícula similar a virus	IATE
thymoctonan	timoctonán	IATE
DNA chip	chip de expresión génica	IATE
tauroselcholic acid	ácido tauroselcólico	IATE
tolonidine	tolonidina	IATE
tiazofurine	tiazofurina	IATE
live genetically modified organism	organismo vivo modificado genéticamente	IATE
metaphylaxis	metafilaxis	IATE
final product	producto final	IATE
teniloxazine	teniloxazina	IATE
Baltic Procurement Initiative	Iniciativa de Adquisiciones del Báltico	IATE
signal management	gestión de señales	IATE

