PRODUCTOS VIGENTES	
Principios activos y nombres comerciales	
Inglés	Español
Afatinib	afatinib	Giotrif
Alteplase	alteplasa	Actilyse
Dabigatran	dabigatrán etexilato	Pradaxa
Empagliflozin	empagliflozina	Jardiance
Empagliflozin + linagliptin	empagliflozina + linagliptina	Glyxambi
Empagliflozin + metformin	empagliflozina + metformina	Jardiance Duo - Synjardy
Idarucizumab	idarucizumab 	Praxbind
Ipratropium	ipratropio 	Atrovent
Ipratropium + Fenoterol	ipratropio + fenoterol	Berodual
Linagliptin	linagliptina	Trayenta
Linagliptin + Metformin	linagliptina + metformina	Jentadueto - Trayenta Duo - Trayentamet
Meloxicam	meloxicam	Mobic
Nevirapine	nevirapina	Viramune
Nintedanib	nintedanib	Vargatef, Ofev
Pramipexole	pramipexol	Mirapex - Sifrol
Spesolimab	espesolimab	Spevigo
Telmisartan	telmisartán	Micardis
Telmisartan + Amlodipine	telmisartán + amlodipina	Micardis Amlo / Twysnta
Telmisartan +  Hydrochlorotiazide	telmisartán + hidroclorotiazida	Micardis Plus
Tenecteplase	tenecteplasa	Metalyse
Tiotropium + Olodaterol	tiotropio + olodaterol	Spiolto
Tiotropium bromide	bromuro de tiotropio	Spiriva
	
Última actualización de los datos: diciembre de 2023.	
